
Villem & McLeod - Crossways feat. Degs (L-Side Remix)
Bou - Envy (Original Mix)
Krakota, Urbandawn - Coyote (Original Mix)
DJ Hazard - When the Dreams Are Over (Original Mix)
Bladerunner - Don't Break It (Original Mix)
Logistics  - Sleeper Dub (Original)
Break - Excuses (Original Mix)
Phaction & Hugh Hardie - Obsession feat. Riya
Droptek - Symbiosis (Original Mix)
Need For Mirrors - Tidal Wavey (Original Mix)
Mefjus, Bou - Wormhole (Original Mix)
Document One, Levela - Steppa (Original Mix)
DLR - Dafunk (Original Mix)
John B - Up All Night (Data 3 Remix)
Mefjus & Inside Info - Repentance
Upgrade (UK) - Base (Original Mix)
Upgrade (UK) - Function (Original Mix)
Annix - Antidote (Original Mix)
Phibes - Got to see her VIP (VIP) (VIP)
DJ Hazard - Time Tripping (Original Mix)
S.P.Y - Wall of Mirrors
Flava D - What You Mean 2 Me (Original Mix)
Fox Stevenson - All Eyes On Me (Original Mix)
Marcia Aiken - I'm Still in Love (Kleu Remix)
Oakwite - Technology (Original Mix)
Invadhertz - Chainsaw (Original Mix)
QZB - Apollo (Original Mix)
Simula - Obscure (Original Mix)
Halogenix - Independent (Original Mix)
Surve - Seasons
